..................................................
..............................#############.......
.............................#....................
.............................#....................
...############..............#....................
.............................#....................
.............................#....................
.............................#....................
.............................#....................
.............................#....................
.............................#....................
.............................#....................
.#...........................#....................
.#................................................
.#..................######........................
.#................................................
.#........#.......................................
.#........####################....................
.#........#.....................................#.
.#........#.....................................#.
.#......#.#.....................................#.
.#####################..........................#.
.#......#.#.........##..........................#.
.#......#.#.........##......#...................#.
.#......#.#.........##......#...................#.
.#......#.#.........##......#...................#.
.#......#.#.........##......#...................#.
.#........#.........##......#..........#........#.
.#........#.........##......#..........#........#.
.#........#.........##......#..........#..........
.#........#.........##......#..........#..........
............................#..........#..#.......
............................#..........#..#.......
.............#################.........#..#.......
.............#################.........#..#.......
.............#################.........#..#.......
.............#################.........#..........
............................#..........#..........
............................#.....................
............................#.....................
...........###################....................
......##################..........................
......................#...........................
......................#...........................
......................#...........................
......................#...........................
..................................................
.#############....................................
..................................................
..................................................