...................................#..............
...................................#..............
...................................#..............
..............#.............#########.............
.........#########.................#..............
.........#########.................#..............
.........#########.................#..............
......####....#....................##########.....
......####....#....................#..............
......####....#...................................
......####....#...................................
......####....#...................................
......####....#...................................
......####....#...................................
......####....#...................................
......####....#...................................
......####....#...................................
......####....#...................................
...##############.................................
.......#.........................................#
.......#....................#.......######.......#
.......#......#.............#....................#
.......#......#.............#....................#
.......#......#.............#..............#.....#
.......#......#.............#..............#.....#
.......#......#............................#.....#
.......#......#............................#.....#
.......#......#............................#.....#
.......#......#............#########.......#.....#
.......#......#............................#.....#
.......#......#............................#.....#
.......#......#............................#.....#
.......#......#............................#.....#
.......#......#............................#.....#
.......#...####............................#.....#
...........####............................#.....#
...........####............................#.....#
...........####............................#.....#
...........####............................#.....#
...........####..........#........................
...........####..........#........................
...........####..........###################......
...........####..........#........................
...........####..........#........................
...........####..........#........................
...........####..........#........................
...........####..........#........................
...................##############.................
..................................................
..................................................