...##...........................#.................
...##...............###################...........
...##...............#...........#.................
...##...............#...........#.................
...##...............#.....#.....#.................
...##...............#.....#.....#.................
...##..#............#.....#.....#############.....
...##..#............#.....#.....#.................
...##..#....#.......#.....#.....#.................
...##..#....#.......#.....#.....#.................
...##..#....#.......#.....#.....#.................
...##..#....#.......#.....#.....#.................
...##..#....#.......#.....#.....#.................
...##..#....#.......#.....#.......................
...##..#....#.............#.......................
...##..#....#.............#.......................
...##..#....#.............#.......................
....#.......#.............#...................###.
....#.......#.............#...................###.
....#.......#.............#...................###.
..###########.............#...................###.
....#.......#.............#...................###.
....#.......#.............#...................###.
....#.......#.............#...................###.
....#.......#.................................###.
....#.........................................###.
....#.........................................###.
....#.........................................###.
....#...........#.............................###.
....#...........#.....................###.....###.
................#.................#########...###.
................#.....................###.....###.
................#.....................###.....###.
................#.....................###.....###.
................#.....................###.....###.
................#.....................###.....###.
...#............#.....................###.....###.
...#................................#.###.........
...#................................#.###.........
...#................................#.###.........
...#................................#.###.........
...#................................#.###.........
...#..................................###.........
...#..................................###.........
...#..............................................
...#..............................................
..................................................
..................................................
.######...........................................
..................................................