..................................................
......#............#.................#............
......#............#.................#............
......#............#.................#............
......#.......#....#.................#............
......#.......#....#.................#............
......#.......#....#.................#............
......#.......#....#.................#............
......#.......#....#.................#............
......################...............#............
..............################.......#............
..............#....#....#............#............
..............#....#....#............#............
..............#....#....#.........................
..............#.#..#....#...#.....................
..............#.#..#....############..............
.........#....#.#..#....############..............
.........#....#.#..#....############..............
.........#....#.#.......############..............
.........#..#.#.#.......#...#.....................
.........#..#.#.#.......#...#.....................
............#.#.#.......#...#.....................
............#.#.#..####################...........
............#...#...........#..............######.
............#...............#.....................
............###############.#.....................
............#...............#.....................
............#...............#.....................
............#...............#.....................
......#.....#...............#.....................
......#.....#.....................................
......#.....#.....................................
......#.....#.....................................
......#.....#.....................................
......#.....#.....................................
......#...........................................
......#...........................................
......#...........................................
......#.............##############................
....................##############................
....................##############................
...........................###....................
...........................###....................
...........................###....................
...........................###....................
...........................###....................
...........................###....................
...........................###....................
...........................###....................
...........................###....................