..................................................
..................................................
..................................................
..................................................
..................................................
..................................................
..................................................
..................................................
.........................#........................
.........................#........................
.........................#........................
.........................#........................
.........................#........................
.........................#........................
.........................#........................
.........................#...#........#...........
.........................#...#........#...........
.........................#...#........#...........
.........................#...#........#...........
.........................#...#........#...........
.........................#...#........#...........
.........................#...#........#.#.........
.....................##########.......#.#.........
.........................#...#........#.#.........
.........................#...#........#.#.........
.............................#........#.#.........
.........#####################........#.#.........
.........#####################........#.#.........
................###########..#........#.#.........
.............................#........#.#.........
.............................#........#.#.........
..........###########........#..........#.........
.............................#..........#.........
.............................#..........#.........
.................####...................#.........
.................####...................#.........
.................####...................#.........
.................####.............................
...##################.............................
.................####.............................
.................####.........################....
.................####.........################....
.................####.........################....
.................####.........################....
.................####..................#..........
.................####..................#..........
.................####..................#..........
.............###############..#######..#..........
.................####..................#..........
.......................................#..........