..................................................
..................................................
.....###..........................................
.....###..........................................
.....###..........................................
.....###..........................................
.....###........#####.............................
.....###........#####.............................
.....###........#####..........###########........
.....###...##########.............................
.....###..........................................
.....###..................##......................
.....###.#........................................
.....###.#........................................
.....###.#........................................
.....###.#........................................
.....###.#........................................
.....###.#.....###########........................
.....###.#.....###########........................
.....###.#.....###########........................
.....###.#.....###########........................
.....###.#........................................
.........#........................................
.........#........................................
.........#........................................
.........#........................................
.........#.................................######.
.........#..############..........................
.........#........................................
.........#........................................
..................................................
..................................................
..................................................
..................................................
..................................................
..................................................
..................................................
..................................................
...........################.......................
...........################.......................
...........################.......................
.......####################.......................
..................................########........
..................................................
..................................................
...........................................######.
..................................................
.........................####################.....
.........................####################.....
..................................................