..................................................
..................................................
........#####.....................................
.......................##.........................
.......................##....................#####
.......................##.........................
.......................##.........................
.......................##.........................
......#................##.........................
......#................##.........................
......#................##.........................
......#...............###.........................
......#.........................................#.
......#...............###.......................#.
.................##...###.......................#.
############.....##...###.......................#.
.........#.......##...###.......................#.
.........#.......##....##.......................#.
.........#.......##....##.........................
.........#.............##.........................
.........#.............##.........................
.#.......#.............##.........................
.#.......#.......................#................
.#.......#...............#.......#................
.#.......#...............#.......#................
.#.......#...............#.......#................
.#.......#...............#.......#................
.#.......#...............#.....################...
.#.......#...............#.......#................
.#.####################..#.......#................
.#.####################..#.......#................
.#.......#...............####....#................
.#.......#...............#.......#................
.#.......#...............#.......#................
.#.......#...............#.......#................
.#.......................#.......#................
.#...............................#......#########.
.................................#......#########.
.................................#......#########.
............####################.#......#########.
..................................................
..................................................
.......................#..........................
.......................#..........................
....................#############.................
.......................#..........................
.......................#..........................
.......................#..........................
.......................#..........................
..................................................