.............................................####.
############.................................####.
############.................................####.
############.................................####.
.............................................####.
.............................................####.
.............................................####.
.............................................####.
...##############.................................
..................#.............####..............
..................#.............####..............
..................#.............####..............
..................#.............####..............
..................#.............####..............
..................##............####..............
..................##............####.....#........
..................##............####.....#........
..................##............####.....#........
..................##............####.....#........
..................##............####.....#........
..................##............####.#...#........
...........####..###################.#...#........
...........####....#............####.#...#........
...........####....#............####.#...#...#....
...........####.................####.#...#...#....
...........####....................#.#...#...#....
...........####....................#.....#...#....
...........####....................#.........#....
...........####....................#.........#....
...........####....................#.........#....
.............................................#....
.............................................#....
.............................................#....
..................................................
...........................................#......
...........................................#......
...........................................#......
............################........#####..#......
...........................................#......
...........................................#......
...........................................#......
.............................#.............#......
...........................................#......
...........................................#......
...........................................#......
...........................................#......
...........................................#......
...........................................#......
...........................................#......
........###########........................#......