......................#...##############..........
..................######################..........
......................#....############...........
......................#............####...........
......................#............###........#...
......................#............###........#...
......................#............###........#...
...#..................#............###........#...
...#...............................###........#...
...#...............................###........#...
...#......................##############......##..
...#...............................###........##..
...#.............................#.#..........##..
...#.............................#.#..........##..
...#........................##############....##..
...#........##########...........#.#..........##..
...#........##########...........#............##..
...#........##########...........#............##..
................#................#............##..
................#................#............##..
................#................#............##..
................#................#............##..
................#................#............##..
................#................#.............#..
................#................#.............#..
................#############..................#..
................#..............................#..
................#..............................#..
................#.....................#........#..
...............############...........#........#..
................#.....................#...........
................#...............#.....#...........
................#...............#.....#...........
................................#.....#...........
................................#.....#...........
................................#.....#...........
................................#.....#...........
................................#.....#...........
................................#.....#...#.......
................................#.....#...#.......
................................#.....#...#.......
......................................#...#.......
..........................................#.......
..........................................#.......
..........................................#.......
..........................................#.......
..........................................#.......
..............######......................#.......
..........................................#.......
...................#################......#.......