..................................................
..................................................
..................................................
..................................................
..................................................
..................................................
..................................................
..................................................
..................................................
............................#..................#..
..........................#.#..................#..
..........................#.#..................#..
..........................#.#..................#..
..........................#.#..................#..
..........................#.#..................#..
..........................#.#..................#..
...#################......#.#..................#..
..........................#.#..................#..
..........................#.#.............#....#..
............................#.............#....#..
............................#............####..#..
............................#............####..#..
.#..........................#............####..#..
.#..........................#............####..#..
.#....................#.....#............####.....
.#....................#.....#............####.....
.#....................#.....#............####.....
.#....................#.....#............####.....
.###########.......####.....#..#######...####.....
.####........##########..................####.....
.........############....................####.....
...##################.#########..........####.....
.#....................#..................####.....
.#....................#..................###......
.#....................#..................###......
.#....................#..................###......
.#....................#..................###......
......................#..................###......
......................#...........................
..................................................
.............................#########............
..................................................
..................................................
..................................................
................######............................
..................................................
..................................................
................###############...................
...................................###############
..................................................