...................................#..............
...................................#..............
...................................#..............
..............#.............#########.............
.........#########.................#..............
.........#########.................#..............
.........#########.................#..............
..............#....................##########.....
..............#....................#..............
......####....#...................................
......####....#...................................
......####........................................
......####........................#######.........
......####....#...................................
......####....#...................................
......####....#...................................
......####....#...................................
......####....#...................................
...#.......######.................................
.......#.........................................#
.......#....................#.......######.......#
.......#......#.............#....................#
.......#......#.............#....................#
.......#......#.............#..............#.....#
.......#......#.............#..............#.....#
.......#......#............................#.....#
.......#......#............................#.....#
.......#......#............................#.....#
.......#......#............#########.......#.....#
.......#......#............................#.....#
.......#......#............................#.....#
.......#......#............................#.....#
.......#......#............................#.....#
.......#......#............................#.....#
.......#...................................#.....#
...........................................#.....#
...........####............................#.....#
...........####............................#.....#
...........####............................#.....#
...........####..........#........................
...........####..........#........................
...........####..........###################......
...........####..........#........................
...........####..........#........................
...........####..........#........................
...........####..........#........................
...........####..........#........................
...................##############.................
..................................................
..................................................