.###############..................................
.###############..................................
.###############..................................
.###############...........#......................
...........................#...###########........
...........................#......................
............#..............#......................
............#..............#......................
...#........#..............#......................
...#........#..............#......................
...#........#..............#......................
...#........#..............#.....#................
...#........#..............#.....#................
...#........#......#.......#.....#................
...#........#......#.............#................
...#........#......#.............#................
...#........#......#.............#................
...#........#......#.............#................
...#...............#.............#................
...#...............#.............#................
...#........#......#.............#................
...#........#......#...........#.#................
...#........#......#...........#.#................
...#........#......#...........#.#...............#
............#..................#.#...............#
............#..................#.#...............#
............#..................#.#......########.#
............#..................#.#......########.#
............#..................#.#...............#
################.................#...............#
............#....................................#
...............#.................................#
...............#.................................#
...............#...........#######...............#
...............#....###########..................#
...............#.................................#
...............#.................................#
...............#.................................#
...............#..#......................#.......#
...............#..#......................#.......#
...............#..##.....................#.......#
...............#..##.....................#........
...............#..##.....................#........
...............#..##.....................#........
...............#..##.....................#........
...............#..##..##################..........
...............#..#.......###############.........
...............#..................................
...............#..................................
...............#..................................