..................................................
......#............#.................#............
......#............#.................#............
......#............#.................#............
......#.......#....#.................#............
......#.......#....#.................#............
......#.......#....#.................#............
......#.......#....#.................#............
......#.......#....#.................#............
......################...............#............
..........................####.......#............
..............#....#....#............#............
..............#....#....#............#............
..............#....#....#.........................
..............#.#..#....#...#.....................
..............#.#..#....###.########..............
.........#....#.#..#........########..............
.........#....#.#..#....###.########..............
.........#....#.#.......###.########..............
.........#..#.#.#.......#...#.....................
.........#..#.#.#.......#...#.....................
............#.#.#.......#...#.....................
............#.#.#..########.###########...........
............#...#...........#..............######.
............#...............#.....................
............###############.#.....................
............#...............#.....................
............#...............#.....................
............#...............#.....................
......#.....#...............#.....................
......#.....#.....................................
......#.....#.....................................
......#.....#.....................................
......#.....#.....................................
......#.....#.....................................
......#...........................................
......#...........................................
......#...........................................
......#.............##############................
..................................................
....................##############................
...........................###....................
...........................###....................
...........................###....................
...........................###....................
...........................###....................
...........................###....................
...........................###....................
...........................###....................
...........................###....................