..................................................
..................................................
..................................................
...............................#..................
...............................#..................
...............................#..................
...............................#..................
............................#..#..................
...........###.......#......#..#..................
...........###.......#......#..#..................
...........###.......#......#..#..................
...........###.......#......#..#..................
...........###.......#......#..#..................
...........###.......#.....###############........
...........###.......#.....###############........
...........###.......#.........#..................
...........###.......#............................
...........###....................................
...........###....................................
...........###....................................
........############..............................
...........###...#................................
...........###...#................................
...........###...#................................
...........###...#................................
..........####...#......................########..
..........#......############.....................
..........#......#................................
..........#......############.....................
..........#......#................................
..........#......#................................
..........#......#................................
..........#......#................................
..........#......#................................
..........#......#................................
.................#................................
............#################.....................
............#################.....................
............#################.....................
.################.................................
.################.................................
..................................................
..................................................
..................................................
............####################.......##########.
...........................#############..........
..................................................
..................................................
..................................................
..................................................