..................#.#........###################..
..................#.#..............#..............
..................#.#..............#..............
..................#.#..............#..............
...........#......#.#..............#..............
...........#......#.#..............#..............
..........######........#####..######.............
...........#......#.#..............#..............
...........#......#.#..............#..............
...........#......#.#............#.#..............
...........#........#.....#......#.#..............
...........#........#.....#......#.#..#...........
######.....#........#.....#......#.#..#...........
#..........#........#.....#......#.#..#..........#
#..........#........#.....#......#....#..........#
#..........#......#.#.....#......#....#..........#
#..........#......#.......#......#....#..........#
#..........#......#.......#......#....#........#.#
#..........#......#.......#......#....#........#.#
#..........#......#.......#......#....#........#.#
#..........#......#.......#......#....#........#.#
#.................#.......#......#....#........#.#
#.................#.......#......#....#........#.#
..................#.......#......#....#........#.#
..................#..............#....#........#.#
.................................#....#........#.#
......................................#..........#
......................................#..........#
......................................#..........#
......................................#..........#
......................................#..........#
.................................................#
..................................................
.................#################................
..................................................
..................................................
..................................................
..................................................
.......................###........................
.......................###........................
.............#################....................
.......................###........................
.......................###...........####.........
.......................###...........####.........
.......................###...........####.........
.......................###...........####.........
.......................###...........####.........
.......................###...........####.........
.......................###...........####.........
.....................................####.........