...........................#......................
...........................#......................
...........................#......................
.................#.........#..................###.
.................#.........#..................###.
.................#.........#..................###.
.................#.........#..................###.
.................#.........#.......##########.###.
...........................#..................###.
...........................#..................###.
...........................#...######.........###.
...........................#...######.............
...........................#......................
...........................#.....#................
........#..................#.....#................
...........................#.....#................
.................................#................
..........................#......#................
...............#################.#................
..........................#......#.#..............
..........................#......#.#..............
..........................#......#.#..............
.......................####........#..............
.......................######...##.#....#.........
..........................#.....##.#############..
.........#................#......#.#....#.........
.........#.......................#.#....#.........
........#################..........#....#.........
.........#..............................#.........
.........#........................................
.........#........................................
.........#........................................
.........#................#.......................
..........................#.......................
..........................#..................#....
..........................#..................#....
...................####################......#....
.#####.......................................#....
...................####################......#....
.............................................#....
..................................................
..................................................
............................................#.....
............................................#.....
............................................#.....
................#############...............#.....
................#############...............#.....
................#############...............#.....
................#############...............#.....
............................................#.....