.........................#........................
.........................#..........#########.....
.........................#..........#########.....
.........................#..........#########.....
.........#...............#..........#########.....
.......###################..........###...........
.........#...............#..........###...........
.........#...............##################.......
.........#..........................###...........
.........#.............###########..###...........
.........#..........................###...........
.........#..........................###...........
.........#...................#......###...........
.######..#...................#....................
.........#...................#....................
........##########...........#...................#
.........#...................#...................#
.........#...................#...................#
.............................#...................#
.............................#...................#
..........................#..#...................#
..........................#..######..............#
..........................#..######..............#
..........................#......................#
..........................#......................#
..........................#......................#
..........................#......................#
..........................#......................#
..........................#......................#
..........................#......................#
..........................#......................#
..........................#......................#
..........................#......................#
..........................#.....#########........#
###################.......#.......................
###################.......#.......................
..........................#.......................
...................####...#.......................
...................####...........................
...................####...........................
...................####...........................
.............#.....####...........................
.............#.....####...........................
.............#.....####...........................
.............#.....####...........................
.............#.....####...........................
.............#.....####...........................
.............#....................................
.............#........................########....
..................................................