..................................................
............##########............................
.....##################...........................
..................................................
..................................................
.....##################...........................
..................................................
..................................................
..................................................
..........#######################.................
..........................#######.................
..................................................
..................##############..................
...........#......................................
.....#######......................................
.....#######........#.............................
######################............................
.#...#######........#.............................
.#.........#........#.............................
.#.........#........#############.................
.#.........#........#....................#........
.#.........#........#....................#........
.#.........#######..#####................#........
...........#........#....................#........
...........#........#.............................
...........#........#.............................
....................#...............######........
................#######...........................
................#######...........................
................#######...........................
..........#####.#######...........................
..........#####.....##............................
.....................#............................
.....................#............................
.....................#............................
.....................#............................
.....................#................#########...
.....................#............................
.....................#............................
.....................####.........................
......................###.........................
......................###.........................
......................###.........................
......................###.........................
......................###.........................
......................###.........................
......................###.........................
......................###.........................
.................#####............................
.....####################.........................