..................................................
............................#.....................
............................#.....................
..........#.................#.....................
..........#.............######....................
..........#.................#.....................
..........#.................#.....................
..........#.................#.....................
..........#.................#.....##..............
..........#.................#.....##..............
..........#.................#...#.##..............
..........###...............#...#.##..............
..........###...............#...#################.
..........###......##################.............
..........###...............#...#.##..............
..........###...............#...#.##..............
..........###...............#...####..............
..........####..............#...####..............
..........##############....#...####..............
..........####..............#...####..............
..........####..................####..............
....##########..................####..............
....##########........##........####..............
.##.##########..................##................
.##..........#..................##................
###..........#..................##................
###..........#..................##................
#########....#..................##................
###..........#..................##................
###....#.....#..................##................
###....#.....#..................##................
###....#.....#....................................
###....#.....#....................................
.##....#.....#....................................
.##....#.....#....................................
.##....#.################.........................
.##....#..........................................
.......#..........................................
.......#..........................................
.......#..........................................
.......#..........................................
.......#..........................................
.......#..........................................
.....###########..................................
.......#..........................................
.......#..........................................
.......#..........................................
.......#..........................................
..................................................
..................................................