..................................................
................###########.......................
..................................................
..................................................
...............................#..................
...............................#.......#..........
...............................#.......#..........
...............................#.......#..........
...............................#.......#..........
...............................#.......#..........
..................#............##############.....
..................#............##############.....
..................#............##############.....
.....#################.........#.......#..........
..................#............#..................
..................#............#..................
..............##..####################............
.........#....##..#............#..................
.#.......########.#...........##############......
.#.......#....##..#...............................
.#.......#....##..#...............................
.#.......#....##..#...............................
.#.......#....##..#............................#..
.#.......#....##..#............................#..
..............##..#............................#..
..............##..#............................#..
..............#................................#..
..............#.............................##.#..
..............#.............................##.#..
..............#.............................##.#..
..............#.............................##.#..
..............#.............................##.#..
..............#................######.......##....
.....######...#.............................##....
.....######...#.............................##....
.....######.................................##....
#########...................................##....
#########...................................##....
#########...................................##....
............................................##....
............................................##....
.................############...............##....
............................................##....
..................................................
..................................................
..................................................
..................................................
..................................................
..................................................
.............................##############.......