..................................................
..................................................
..................................................
..................................................
..................................................
..................................................
..................................................
.........###################......................
............##....................................
............##....................................
............##....................................
............##....................................
............##....................................
............##....................................
..................................................
..................................................
..................................................
..................................................
...............#..................................
...............#..................................
...............#..................................
.....#####.....#..................................
.....#####.....#..................................
.....#####.....#..................................
...............#..................................
...............#....................#############.
...............#....................#############.
...............#....................#############.
...............#...#############..................
...............#..................................
..................................................
.....................####.........................
.....................####.........................
.....................####...##################....
.....................####...##################....
.....................####...##################....
.....................####...##################....
.....................####.........................
.....................####.........................
.....................####.........................
.....................####.........................
.....................####.........................
................#################.................
................#################.................
..######.............####.........................
.....................####.........................
.....................####.........................
..............##############......................
.....................####.........................
.....................####.........................