..................................................
###..#######.................................####.
##..########.................................####.
##.#########.................................####.
.............................................####.
.............................................####.
.............................................####.
.............................................####.
...##############.................................
..................#.............####..............
..................#.............####..............
..................#.............####..............
..................#.............####..............
..................#.............####..............
..................##............####..............
..................##............####.....#........
..................##............####.....#........
..................##............####.....#........
..................##............####.....#........
..................##............####.....#........
..................##.................#...#........
...........####..###################.#...#........
...........####....#............####.#...#........
...........####....#............####.#...#...#....
...........####.................####.#...#...#....
...........####....................#.#...#...#....
...........####....................#.....#...#....
...........####....................#.........#....
...........####....................#.........#....
...........####....................#.........#....
.............................................#....
.............................................#....
.............................................#....
..................................................
...........................................#......
...........................................#......
...........................................#......
............################........#####..#......
...........................................#......
...........................................#......
...........................................#......
.............................#.............#......
...........................................#......
...........................................#......
........####...............................#......
...........................................#......
...........................................#......
...........................................#......
...........................................#......
........###########...............................