..................................................
..................................................
................######################............
.....................................#............
.....................................#............
..................................................
..................................................
.........###################......................
............##....................................
............##....................................
............##....................................
............##....................................
............##....................................
............##....................................
..................................................
.................................###..#####.......
..................................................
..................................................
...............#..........................#.......
...............#..........................#.......
...............#..........................#.......
.....#####.....#..........................#.......
.....#####.....#..........................#.......
.....#####.....#..................................
...............#..................................
...............#....................######.######.
...............#...........................######.
...............#....................######.######.
...............#...#############..................
...............#..................................
..................................................
.....................####.........................
.....................####.........................
.....................####...##################....
.....................####...##################....
.....................####...##################....
.....................####...##################....
.....................####.........................
.....................####.........................
.....................####.........................
.....................####.........................
.....................####.........................
..................................................
................#################.................
..######.............####.........................
..................................................
.....................####.........................
..............##############......................
.....................####.........................
.....................####.........................