.............................#....................
.............................#..#...........#.....
.............................#..#...........#.....
.............................#..#...........#.....
............#................#..#...........#.....
...############....#..##################....#.....
...############....#...###########..........#.....
...........###################..#...........#.....
............#......#.........#..............#.....
............#......#.........#..............#.....
............#......#.........#..............#.....
............#......#.........#..............#.....
............#......#.........#..............#.....
............#................#..............#.....
............#................#....###.......#.....
............#................#....###.............
............#................#....###.............
........#################################.........
............#.................#######.............
............#.....................###.............
............#.....................###.............
............#.....................###.............
............#...#####################.............
..................................###.............
..................................###.............
..................................###.............
..########........................###.............
..................................###..##.........
..................................###.............
..................................................
..................................................
..................................................
..........................########................
..........................########................
..........................########................
..................................................
..................................................
..................................................
..................................................
.........................................#........
.........................................#........
.........................................#........
............................#............#........
............................#............#........
............................#............#........
............................#............#........
..................##################.....#........
.........................................#........
..................................................
..................................###########.....